- - - * * o - -
i * * * - * * -
- - * * - - * -
* - - - - - - -
- - * * * - - -
