*-*-*-*-*-*-i
-----**--*--*
-*-*-*o*---*-
-*-*-*-*-*-*-
**-*-*---*-*-
*************