-----****--**
i---**-*-*---
*-*-**----*-*
-------*---**
*-*-*-*-**--o